000000000000000000
00000XXXXXXXX00000
00000XXXZXXZX00000
0XXX0XXZZZXZX00000
0XZXDXZXXXXZX0XXX0
0XZX0XXXZZZXX0XZX0
0XZX0XZXXXXXX0XZX0
0XZX0XXZXZZZX00XX0
0XX00XZZXXZZX00XX0
0XX00XXZZXZXXDXXX0
0XX00XXXXXXXXDXZX0
0XX00000DD00000XX0
0XX00000XX00000XX0
0XXX0XXXXXXXX00XX0
0XZX0XZZZZZZXDXZX0
0XZX0XXXXXXXXDXXX0
0XZXDXZZZZZZX00000
0XZXDXXXXXXXX00000
0XZX0XXZXXZXX00000
0XZX0XXZXXZXXDXXX0
0XXX0XZZZZZZXDXZX0
00000XXXXXXXX0XZX0
00000000DD0000XZX0
00000000XX0000XZX0
00000000XX0000XXX0
0000000XXXX0000000
0000000XZZX0000000
0000000XXXX0000000
0000000XZZX0000000
0000000XXXX0000000
0000000XZZX0000000
0000000XZZX0000000
0000000XXXX0000000
000000XXZZXX000000
000000XZZZZX000000
000000XXZZXX000000
000000XXXXXX000000
00000000DD00000000
000XXXXXXXXXXXX000
000XZZZZZZZZZZX000
000XZZZZZZZZZZX000
000XXXXXXXXXXXX000
000000000000000000
