000000000000000000
00000XXXXXXXX00000
00000XXXXXXXX00000
0XXXDXXXXXXXX00000
0XXXDXXXXXXXX0XXX0
0XXX0XXXXXXXX0XYX0
0XXX0XXXXXXXX0XXX0
0XXX0XXXXXXXX00XX0
0XX00XXXXXXXX00XX0
0XX00XXXXXXXX0XXX0
0XX00XXXXXXXX0XXX0
0XX00000DD00000XX0
0XX00000XX00000XX0
0XXX0XXXXXXXX00XX0
0XXX0XXXXXXXXDXXX0
0XXX0XXXXXXXXDXXX0
0XXX0XXXXXXXX00000
0XXX0XXXXXXXX00000
0XBX0XXXXXXXX00000
0XXX0XXXXXXXXDXXX0
0XXX0XXXXXXXXDXXX0
00000XXXXXXXX0XXX0
00000000DD0000XXX0
00000000XX0000XGX0
00000000XX0000XXX0
0000000XXXX0000000
0000000XXXX0000000
0000000XXXX0000000
0000000XXXX0000000
0000000XXXX0000000
0000000XXXX0000000
0000000XXXX0000000
0000000XXXX0000000
000000XXXXXX000000
000000XXXRXX000000
000000XXXXXX000000
000000XXXXXX000000
00000000DD00000000
000XXXXXXXXXXXX000
000XXXXXXXXXXXX000
000XXXXXXXXXXXX000
000XXXXXXXXXXXX000
000000000000000000
